Alex Mwaleh	F	Y
Alex Kang'ethe	F	Y
Brian Mosigisi	F	Y
Brian Koech F	N
Eric Gichuri	F	N
Gertrude Nyenyeshi	F	Y
Godson Ukpere	S
Joshua Mwaniki	S
Benjamin Kagia	F	Y
Kevin Gathuku	F	N
Mahad Walusimbi	F	Y
Anthony Nandaa	S
Jeremy Kithome	F	Y
Robert Opiyo	S
Stacey Achungo	F	N
Teddy Asola	F	N
Thomas Nyambati	F	Y
Christina Sass	S
Collin Mutembei	F	Y
Eugene Mutai	F	N
Ganga Chris	F	Y
Evan Greenlowe	S
Hannah Koske	F	Y
Hellen Maina	S
Jee Githinji	F	N
Joan Ngatia	F	Y
Jackson Saya	S
Lewis Maina	F	Y
Nate artin	F	Y
Nyambura Kihoro	S
Oscar Opondo	S
Michael Rosenberg	S
Meshack Nyabiba	S
Stanley Ndagi	F	Y
Christopher Vundi	F	Y
